NO      textures/wolfenstein/grey_stone.xpm
SO      textures/wolfenstein/red_brick.xpm
WE 		textures/blue-wall.xpm
EA 		textures/blue-wall-skeleton.xpm
W5      textures/bookshelf.xpm
W6      textures/simonkraft/respawn_anchor_side3.xpm

F  10, 10, 10
C  10, 10, 10

111166111111111111111111111111111111111111111111111
100000013434341666666661555555500011              1
10E0000|000000|0000s0001000000500001              1
10000001343434100000000|000000500001              1
111222210010002000000001000000500011              1
100000010001000000000001555555500011              1
10000001111111000000000111111110000|              1
10s00000000001000000000|000010000001              1
1000011100001000000s0001000010000001              1
100001010000100000000001000010000011              1
10000101s00010000h000001000010000001              1
100001011110000000000001111110000011              1
10000000000000000000000a0000a0000001              1
111111111111111111111111111111111111111111111111111
