WE      textures/wolfenstein/grey_stone.xpm
NO      textures/wolfenstein/red_brick.xpm
SO 		textures/wolfenstein/red_brick.xpm
EA 		textures/wolfenstein/wood.xpm

F  20,    20,    	20
C  255,		255,     255

111111111111111111111111111111111111
1000000100s0000000000000000000000011
10E0000|00000000000s0000000000000001
100000011-11000000000001111111000101
111111110001000000000001000001000001
100000010001000000000001000010000011
10000001111111000000000|0h0010000001
10s00000000001000000000100001000q011
1000011100001000000s00010h0010000001
100001010000100000000001000010000011
10000101s00010000h000001000010000001
100001011110000000000001111110000011
10000000000000000000000a0000a0000001
111111111111111111111111111111111111
