WE      textures/wolfenstein/grey_stone.xpm
NO      textures/wolfenstein/red_brick.xpm
SO 		textures/blue-wall.xpm
EA 		textures/blue-wall-skeleton.xpm

F  20,    20,    	20
C  255,		255,     255


111111111111111111111111111111111111
100000013434341000000001555555500011
10E0000|000000|0000s0001000000500001
10000001343434100000000|000000500001
11122220001000200000001000000500001
100000010001000000000001555555500011
10000001111111000000000|0h2000000001
10s00000000001000000000222201000q011
1000011100001000000s00010h0010000001
100001010000100000000001000010000011
10000101s00010000h000001000010000001
100001011110000000000001111110000011
10000000000000000000000a0000a0000001
111111111111111111111111111111111111
