NO ./textures/wall1-1.xpm
SO ./textures/wall1-2.xpm
WE ./textures/wall1-3.xpm
EA ./textures/wall1-4.xpm

F 164,169,20
C 153,204,255

111111111111111111111
101000001000000000001
1N1000001000000000001
111111111111111111111

