NO textures/simonkraft/respawn_anchor_side0.xpm
EA textures/simonkraft/respawn_anchor_side2.xpm
SO textures/simonkraft/respawn_anchor_side4.xpm
WE textures/simonkraft/respawn_anchor_side3.xpm

F 164,169,20
C 153,204,255

111111111111111111111
100000000000000000001
100000000000000000001
100000000000000000001
10000000000N000000001
100000000000000000001
100000000000000000001
100000000000000000001
101000001000000000001
111111111111111111111

