NO textures/wall-2-n.xpm
EA textures/wall-2-e.xpm
SO textures/wall-2-s.xpm
WE textures/wall-2-w.xpm

F 164,169,20
C 153,204,255

111111111111111111111
100000000000000v00001
1W0000000000000000001
100000000000000v00001
100000000000000v00001
100000000000000v00001
100000000000000v00001
100000000000000v00001
100000000000000v00001
100000000000000v00001
100000000000000v00001
100000000000000v00001
111111111111111111111

