




NO textures/wall-2-n.xpm
EA textures/wall-2-e.xpm
SO textures/wall-2-s.xpm
WE textures/wall-2-w.xpm

F 50,50,50
C 153,204,255

11111111111111111111111111111111111111111111111
10000000000000v00000000000000000000000000000001
10000000000000v00000000000000000000000000000001
10000000000000v00000000000000000000000000000001
10000100000000v00000000000000000000000000000001
100E0|00000000v00000000000000000000000000000001
10000100000000v00110100000000000000000000000001
10000000000000v00110100000000000000000000000001
10001100s00000100000100000000000000000000000001
10000000000000|00000100000000000000000000000001
10000010000000100000100000000000000000000000001
10000000000000v00100100000000000000000000000001
10000010000000v00000100000000000000000000000001
10100000100000v00000100000001000000000000000001
10000000000000v00100100000000000000000000000001
10000010000000v00000100000000000000000000000001
10100000100000v00000100000000000000000000000001
11111111111111111111111111111111111111111111111
