




NO textures/wall-2-n.xpm
EA textures/wall-2-e.xpm
SO textures/wall-2-s.xpm
WE textures/wall-2-w.xpm

F 50,50,50
C 153,204,255

11111111111111111111111111111111111111111111111
1   1111111000v00000000000000000000000000000001
1 E |     10000v00000000000000000000000000000001
111111111 1000v00000000000000000000000000000001
1       1 1000v00000000000000000000000000000001
1       1 1000v00000000000000000000000000000001
1             v00110100000000000000000000000001
10000000000000v00110100000000000000000000000001
10001100000000v00000100000000000000000000000001
10000000000000000000100000000000000000000000001
10000010000000v00000100000000000000000000000001
10000000000000v00100100000000000000000000000001
10000010000000v00000100000000000000000000000001
10100000100000v00000100000001000000000000000001
10000000000000|00100100000000000000000000000001
10000010000000v00000100000000000000000000000001
10100000100000v00000100000000000000000000000001
11111111111111111111111111111111111111111111111
