




NO textures/wall-2-n.xpm
EA textures/wall-2-e.xpm
SO textures/wall-2-s.xpm
WE textures/wall-2-w.xpm

F 50,50,50
C 153,204,255

111111111111111111111
10000000000000v000001
10000000000000v0011001
10001100000000v000001
10000000000N000000001
10000010000000v000001
100000000000000001001
10000010000000v000001
10100000100000v000001
111111111111111111111
