   WE                            textures/wolfenstein/grey_stone.xpm
NO      textures/wolfenstein/purple_stone.xpm



SO textures/wolfenstein/red_brick.xpm

F      17,    38,     64

EA textures/wolfenstein/wood.xpm

C 218, 234, 235

111111111111111111111111111111111111111111111111111111111
100000000000000000000000000000010000000000000000000000001
1000sss00000000000000000000000010000000000000000000000001
1000000s00s00s000000s000000000010000000000000000000000001
1000s00s000000sssss0ss00000000010000000000000000000000011
1000s000000000s00000s0000000000100000000000000000a0000001
10000ssss00q00s00000s000011111110000000000000000000000001
100000s0000000000000s0q00|0000||0000000000000W00000000001
1000000s0s00000000s00000011111110000000000000000000000001
10000000000s0000s0000000000000010000000000000000000000001
100000s000000s0s00000000000000010000000000000000000000001
10000s000000000000000000000000010000000000000000000000001
100000000000000000000000000000010000000000000000000000001
111111111111111111111111111111111111111111111111111111111
