   WE                            textures/wolfenstein/grey_stone.xpm
NO      textures/wolfenstein/purple_stone.xpm



SO textures/wolfenstein/red_brick.xpm

F      17,    38,     64

EA textures/wolfenstein/wood.xpm



C 218, 234, 235

111111111111111111111111111111111111111111111111111111111
10S011000010000000000000000000000000000000000000000000001
100011000000000011111100100000000000000000000000000000001
100011000000000011000100100000000000000000000000000000001
100000000010000000000100100000000000000000000000000000001
111111111111111111111111111111111111111111111111111111111
